NO ./textures/b_smoke.xpm
SO ./textures/greystone.xpm
WE ./textures/colorstone.xpm
EA ./textures/clouds.xpm
F 220,100,0
C 225,30,0
1111111111111111111 11111111111111111111111111111111111111111111111111
100000000000000001110000000000010000000000000000000000000100000000001
100000000000011100000000000011110000000000000000000000000111111111111
100000000010010000000000000000000100000000000000000000000001
11111111011101000001110000000000100000000000000000000000001
10000000001100000111011111111111100000000000000000000000001
11110111111111011100000010001111100000000000000000000000001
11110111111111011101010010001111100000000000000000000000001
11000000110101011100000010001111111111111110111111111111111
1000001000011000011000000110101100000000000000000000000001
1000000000010000110101001111011100000000000000000000000001
1100001110101011111011111000001000000000000000000000000001
11110111 111010111 111101111000100000000000000000000000001
11111111 111111111 111111111111111111111110111111111111111
        11111111111 11111111111111111111110111111111111111111111111111
        10000000001110000000000010000000000000000000000000100000000001
        10000011100000000000011110000000000000000000000000111111111111
        10010000000000000000000100000000000000000000000001
11111111011101000001110000000000100000000000000000000000001
10000000001100000111011111111111100000000000000000000000001
11110111111111011100000010001111100000000000000000000000001
11110111111111011101010010001111100000000000000000000000001
11000000110101011100000010001111111111111101111111111111111
1000001000011000011000000110101100000000000000000000000001
100000000001000011010100111101110000000000N000000000000001
110000111010101111101111100000100000000000000000000000001
111101110111010111 111101111000100000000000000000000000001
111111111111111111 111111111111111111111111111111111111111
11111
