NO textures/b_smoke.xpm
SO textures/stars.xpm
WE textures/starfall.xpm
EA textures/smoke.xpm
F 220 , 35, 0
C 225 ,30, 0

11111111111111111111111111111111111111
10000000000000000000000000000000000001
10000000000000000000000000000000000001
10000000000000000000000000000000000001
10000000000000000000000000000000000001
10000000000000000000000000000000000001
10000000000000000000000000000000000001
10000000000000000000000000000000000001
10000000000000000001000000000000000001
1000000000000000001N000000000000000001
10000000000000000001000000000000000001
10000000000000000000000000000000000001
10000000000000000000000000000000000001
10000000000000000000000000000000000001
10000000000000000000000000000000000001
10000000000000000000000000000000001001
11111111111111111111111111111111111111
