NO textures/b_smoke.xpm
SO textures/stars.xpm
WE textures/starfall.xpm
EA textures/smoke.xpm
C 48 , 25, 52
F 137 , 207, 240

11111111111111111111111111111111111111
10000000000000000000000000000000000001
10000000000000000000000000000000000001
10000000000000000000000000000000000001
10000000000000000000000000000000000001
10000000000000000000000000000000000001
10000000000000000000000000000000000001
10000000000000000000000000000000000001
10000000000000000001000000000000000001
10000000000000000010000000000000000001
10000000000000000001000000000000000001
1000000000000000000000000000N000000001
10000000000000000000000000000000000001
10000000000000000000000000000000000001
10000000000000000000000000000000000001
10000000000000000000000000000000001001
11111111111111111111111111111111111111
