NO textures/b_smoke.xpm
SO textures/stars.xpm
EA textures/smoke.xpm
WE textures/starfall.xpm
C 255 , 255 , 255
F 33 , 62 , 4

1111111111111111111
11111111
10111
10001
10001
1N1111111111111111
 1
